100000000000000000000000001
000000000000000000000000001
000000000000000000000000001
111111111110010011111111111
100000000000000000000000001
100000000000000000000000001
100000000000000000000000001
100001110000010011111111111
100000000000000000000000001
100000000000000000000000001
100000000000000000000000001
111111111111100000011100001
100000000000000000000000000
100000000000000000000000000
100000000000000000000000000
111111111100111111111111111